0
0
0 0

22222222222222222222222222222222
20000110000000011110000000000002
20000110000000000000000000000002
20000000000000000000000000000002
20000000000000000001111000000002
21111111100000000000000000000002
20000000000000000000000001100002
20000000000000000011000000000002
20000011000000000000000000000002
20000000000011110000000000000002
20000000000000000000000000000002
20000000000000000110000000000002
20000000000000000000000000000002
21111000000000000000111100000002
20000000000000000000000000110002
20000000000000110000000000000002
30000000000000110045000000000453
11111111111111111111111111111111